{
"_template":{"MAP":[[null]],
	"MOBS":[null],
	"LEVELMIN":0,
	"LEVELMAX":0,
	"GROUP_NUMBER":3
	},
"(0,0)":{"MAP":[
	[2, 2, 2, 0, 0, 0, 0, 0, 0, 0, 0, 0, 0, 0, 0, 0, 0, 0, 0, 0, 1, 1, 1, 0, 0, 0, 0, 0, 0, 0, 0, 0], 
	[2, 2, 2, 0, 0, 0, 0, 1, 0, 0, 0, 0, 0, 0, 0, 0, 0, 0, 0, 0, 1, 1, 1, 0, 0, 0, 0, 1, 1, 0, 0, 0], 
	[2, 2, 2, 0, 0, 0, 0, 0, 0, 0, 0, 0, 0, 0, 0, 0, 0, 0, 0, 0, 1, 1, 1, 0, 0, 0, 0, 0, 0, 0, 0, 0], 
	[0, 1, 1, 0, 0, 0, 0, 0, 2, 2, 0, 0, 0, 0, 0, 0, 0, 0, 0, 0, 1, 1, 1, 0, 1, 1, 0, 0, 0, 0, 0, 0], 
	[0, 1, 1, 1, 0, 2, 2, 2, 2, 2, 0, 0, 0, 1, 0, 0, 0, 0, 1, 0, 0, 0, 1, 0, 1, 1, 1, 0, 0, 0, 0, 0], 
	[0, 0, 1, 1, 0, 2, 2, 2, 1, 1, 2, 2, 0, 0, 0, 0, 0, 1, 1, 1, 1, 1, 0, 0, 0, 0, 0, 0, 0, 0, 0, 0], 
	[0, 0, 0, 0, 0, 1, 1, 2, 1, 1, 2, 2, 0, 0, 0, 0, 0, 1, 1, 1, 1, 1, 1, 0, 0, 0, 0, 0, 0, 0, 0, 0], 
	[0, 0, 0, 0, 0, 1, 1, 2, 2, 2, 1, 1, 0, 0, 0, 0, 0, 1, 1, 1, 1, 1, 0, 0, 0, 0, 0, 0, 0, 0, 0, 0], 
	[0, 0, 0, 0, 1, 1, 1, 2, 2, 2, 1, 1, 1, 0, 0, 0, 0, 1, 1, 1, 1, 1, 0, 0, 0, 0, 0, 0, 0, 1, 0, 0], 
	[0, 0, 1, 0, 1, 1, 1, 2, 2, 2, 2, 2, 1, 0, 0, 2, 0, 1, 1, 1, 0, 0, 0, 0, 0, 0, 2, 2, 2, 0, 0, 0], 
	[0, 0, 0, 0, 0, 0, 1, 1, 1, 2, 2, 2, 0, 0, 2, 1, 2, 0, 0, 0, 0, 0, 0, 0, 0, 1, 1, 2, 2, 0, 0, 0], 
	[0, 0, 1, 1, 0, 0, 0, 0, 1, 2, 2, 2, 0, 0, 0, 2, 0, 0, 0, 2, 1, 0, 0, 2, 2, 1, 1, 1, 1, 0, 0, 0], 
	[0, 0, 1, 1, 0, 0, 0, 1, 1, 2, 2, 2, 1, 1, 0, 0, 0, 0, 2, 2, 2, 0, 0, 2, 2, 0, 1, 1, 1, 2, 0, 0], 
	[2, 2, 2, 0, 0, 0, 0, 1, 1, 1, 1, 1, 1, 1, 1, 1, 1, 0, 2, 2, 2, 2, 2, 1, 1, 0, 0, 2, 2, 2, 2, 0], 
	[2, 2, 2, 1, 0, 2, 2, 2, 2, 1, 1, 1, 2, 2, 1, 1, 2, 2, 2, 1, 2, 2, 2, 1, 1, 0, 0, 0, 1, 1, 0, 0], 
	[2, 2, 2, 1, 1, 2, 2, 2, 2, 2, 2, 2, 2, 2, 2, 2, 2, 2, 2, 1, 1, 1, 1, 0, 0, 0, 1, 1, 1, 1, 0, 0],
	[1, 1, 1, 2, 2, 1, 1, 2, 2, 2, 2, 1, 1, 1, 1, 1, 1, 1, 1, 0, 1, 1, 0, 0, 0, 0, 1, 1, 0, 0, 0, 0], 
	[1, 1, 1, 2, 2, 1, 1, 2, 2, 2, 2, 1, 1, 1, 2, 2, 1, 1, 1, 0, 0, 0, 0, 0, 0, 0, 0, 0, 0, 0, 0, 0]
	],
	"MOBS":["001", "002", "003"],
	"LEVELMIN":1,
	"LEVELMAX":6,
	"GROUP_NUMBER":1
	}
}
